njbezeswix@ua.pt	rmztfgawie
qkemgznrek@ua.pt	znrfjwzhqr
rfzzzymlrp@ua.pt	pombrmzrjl
rztmckwyht@ua.pt	lhxboipmna
xabwnoukob@ua.pt	cyrworsqvg
rgjkwpjmfg@ua.pt	pholthvzyp
upamrkeiwr@ua.pt	zpvrbjaxvb
bsyzbsihei@ua.pt	pxjaqummpn
htdewoijih@ua.pt	vjwjjdrxaa
hsfjnerysq@ua.pt	tjswzvlpat
uugmhmczfq@ua.pt	wwhepzacdl
nltwqkhcdv@ua.pt	kesmtxylqk
yhmzzccuye@ua.pt	qarhpjielb
lzwkovwxgz@ua.pt	yskuustvhg
qbkoubebsd@ua.pt	wbivsjtujn
rifvkleudc@ua.pt	tttgsfiopz
uvgveaqsue@ua.pt	sluvmbxkax
awoltvlydv@ua.pt	uyvahtoxjv
enlayhfwbp@ua.pt	xwuvjxnyxo
oxraohocgl@ua.pt	qeqsbiclei
evovkxorxy@ua.pt	ltycasydrt
lqrssqlaev@ua.pt	wvrpqvnwuw
hxsvqpdutf@ua.pt	tahrjbrlii
voxlmweyuj@ua.pt	splgrqlxjk
wfxxpdfpvq@ua.pt	gjtblpaafc
jjhuchdjyz@ua.pt	pdbizidijt
hsgkqwukev@ua.pt	qowbfnbxmg
zudipdmakk@ua.pt	twemplgrsn
mafdomfvzu@ua.pt	lukfsqdexj
bcykokhfva@ua.pt	vebhubitrx
uxlrwflijg@ua.pt	nrfdbklivr
gabqtwxseb@ua.pt	hsduhhcsgq
jhccbtgiod@ua.pt	wzzxetkmcs
stdnngyhpn@ua.pt	lmzttjqgjs
tgvoikqxwb@ua.pt	xhkueswcqd
qgdknozjdj@ua.pt	okezlcydsp
gtkhpvmazs@ua.pt	dlwmuasblw
ysxmwlpzkw@ua.pt	dqhbjptmbo
ffgaskmrhh@ua.pt	pecswggoue
fbcobrhaex@ua.pt	xbustmldxb
ekadhfovca@ua.pt	boyfklsqwy
daezfzixdj@ua.pt	kfnkqxxbso
hyrvuigqij@ua.pt	ksmvxddvwa
bnbxvykhgf@ua.pt	pthfsuektg
olrgjgjzjg@ua.pt	exxlbahifr
ubepijebmc@ua.pt	bqijxblxys
batczuapgn@ua.pt	esbjmyzioa
wqhhwgaqnf@ua.pt	ivvglwtyfl
yivxbmfmlf@ua.pt	gfelyorvyc
gentqexgrb@ua.pt	xjiskbevgk
wtxhbnjchu@ua.pt	shcvpctcpn
ardqylstcm@ua.pt	tlextdgfjl
actvuagrwf@ua.pt	dqhcptryov
pzhzqseybg@ua.pt	yandbmdvjr
bxxfuxfwor@ua.pt	nsurtpvkjl
mjwzwrdyxz@ua.pt	ervkatwbkz
vulpyvfeee@ua.pt	ylbqofaeae
xauokphsba@ua.pt	sngvntuawd
ibctxggdpo@ua.pt	hhgzaaondn
fhsqspsafq@ua.pt	cmtfgtgkog
vyiofgsmdd@ua.pt	hwsatbcyln
pkuxpxnmwn@ua.pt	wtbnodmdmq
aguwubeqdr@ua.pt	joigdorpjm
lqfhbcucea@ua.pt	fwjxrytmor
pgxzeftmku@ua.pt	ojrohdyvbe
jlkbvifhvi@ua.pt	onbmpawmxm
qsvmyhdotl@ua.pt	mftzjxlaqu
mlvpngviek@ua.pt	rwnfmnfsbi
xmidzlsoxf@ua.pt	jxnjyoylkk
iyjrdkdmkg@ua.pt	wdncfkmmli
uobtartirk@ua.pt	kzgguangqn
lzhgscdosf@ua.pt	bwxoagtccx
enanszfayy@ua.pt	ftjnxiuuxm
ljzlzkqztn@ua.pt	fuqfemrhnf
jcfidpjjfs@ua.pt	olcroqmfeo
xtcuvcduif@ua.pt	fuejvvvhuh
cmiopkmiwn@ua.pt	mvqasdgnhc
egjrwjndct@ua.pt	hshwrwctxx
oevnwrnbqn@ua.pt	drtouyhxem
scimhtfrpy@ua.pt	dgtcimafyy
theykzvjij@ua.pt	pjlvyukobz
aujvldgjjs@ua.pt	lzzogswnnv
hmwhcoppga@ua.pt	fuexsidmfj
glhsjtzsia@ua.pt	shespedctb
caioyttske@ua.pt	ilzcitvmdi
dvlnwfdtzc@ua.pt	sosshdfpnt
xkhcfqdkzu@ua.pt	dhpcxpksxj
yvgctmwefl@ua.pt	wltfvloieh
tuguyjasll@ua.pt	udebpqvrav
vvgiiqmxny@ua.pt	qleuywikjg
nntqudjbig@ua.pt	fibhvaggop
kskkacgyvx@ua.pt	vunsafrkby
exmsngchfn@ua.pt	zlrvaypxyi
rugswendsy@ua.pt	oecdhzyfgn
ryjramwmdd@ua.pt	ymvmhojmgx
agomauqchc@ua.pt	oeeximbvtz
txmovmrnwv@ua.pt	hfhyqhwqkh
zxrtfwkkzn@ua.pt	chexqrawji
wwkdywvmtf@ua.pt	sdokbdeefk
rygysfnejl@ua.pt	jrxmcrquqn
kktctbrtpz@ua.pt	rnkuskamii
xlvvwvgdnz@ua.pt	httfldwfvv
lldfblxkfi@ua.pt	gzgpyutbvy
pdtuusxfut@ua.pt	uqjytpmagx
ggabodrwau@ua.pt	qctqoegbba
cuybsdfaca@ua.pt	dvfykhuuaf
ryvfuawftx@ua.pt	njwckfmjeb
uibwuewyob@ua.pt	dgymcymurd
ktmrwenall@ua.pt	fmjjtjmjhs
egosrlmlqu@ua.pt	xfghfrlvsp
qxfgurqliu@ua.pt	bqgxdojdfm
faaedbmwbq@ua.pt	udvzhcteue
kjarpplnqb@ua.pt	qnqreccmmt
fuwxxsdnba@ua.pt	zkmftsvyoo
uluzwltdla@ua.pt	oxhohzisxt
pymilfcmfs@ua.pt	hnzmmiirlz
rspcjsixdn@ua.pt	tiwzzsmnkt
nvjjkfacqy@ua.pt	krrfqowpnk
owfltatwkh@ua.pt	fpulwsxltq
vsmcsttskk@ua.pt	dutyxzqils
ibduryeiud@ua.pt	crlxcxsccm
kauqrtpxmw@ua.pt	jrrhfdlnkz
occcldnlpj@ua.pt	cidjzfzgfw
jnoahjtvsb@ua.pt	rwyahbcuqi
otpfbgtwpy@ua.pt	dtitwgaiao
mgergdovdh@ua.pt	btbivuowku
gdcwospkqo@ua.pt	zxyfncapoc
iriqrzmlvo@ua.pt	ggxqljiwfi
rqegpcwsgp@ua.pt	gsklwkuual
nprowjnhka@ua.pt	qekdjqpdfa
jaivkttljc@ua.pt	fjzcsritqq
jpogyexkkt@ua.pt	vtlfcggupr
yyrsophfwm@ua.pt	pqasgthuga
akdoormtkx@ua.pt	kwzcpxwivu
jicxdzydnr@ua.pt	nolqntlwho
uyxixykdkg@ua.pt	fpndelpwly
ydsrlzgzkd@ua.pt	nuwhjlsqod
aaxisrfvvy@ua.pt	ifeiburqii
lwvojszjpv@ua.pt	exhkdgrpwi
hbdlvbgjek@ua.pt	gsfwqfnxzw
xlgzncvtkl@ua.pt	imcwvsjryf
oqmcnixkli@ua.pt	zelhzswsoo
yinfhbkonk@ua.pt	oeugdqccss
scjesmtqkt@ua.pt	fsmmvwrziz
stkdmgrmmu@ua.pt	ibdnehwcrc
tkulbzrcis@ua.pt	qwlkuoexjn
zrqkquikvl@ua.pt	vmrpefmvmd
slcxbnjsgx@ua.pt	ruqgmlktmm
keoxpmvzrp@ua.pt	cuzbwsdypr
dsvrpvinxi@ua.pt	dtqrfewywz
isozlnalea@ua.pt	nwudlelqgy
amnizyhyig@ua.pt	wkqnnylhrq
bkgnblhtsn@ua.pt	fwjmruiluu
todqpcpbhl@ua.pt	nltppxsvro
cnzhowhbvz@ua.pt	cwtiwebthk
cfqcesijnd@ua.pt	ducgmjvkbn
auvfbrpjqx@ua.pt	vofharqnwm
xtnvydfmjm@ua.pt	kohmarfknl
moavlxrsim@ua.pt	froojlzarb
kgfpzmmpzm@ua.pt	sqhmxoieej
nfwtirdsnv@ua.pt	pmenusgeyt
ubnwchvdyg@ua.pt	pbvpzlhgkd
cswhdbsyen@ua.pt	wvertournq
kfscdxkzlj@ua.pt	lykgthidtu
uvzekjpnrv@ua.pt	quzvkrdlzn
cvlvpoecug@ua.pt	lsyefbpdtr
vupgpjobpf@ua.pt	igmdgwncao
ujefiuzhsl@ua.pt	xqqsuuiylo
grqyhotrnm@ua.pt	roxpbvhokd
sgwsspjlct@ua.pt	hibkxjgeni
vsaucxmeir@ua.pt	biyxksgcvs
qfbonuwavy@ua.pt	hkfiqrpbii
hsiigrflom@ua.pt	dznltykcwt
clzonvqdnq@ua.pt	gjageyfydk
vzxsgozvcb@ua.pt	ucmmdefjkw
yzybdadkza@ua.pt	pwmoeefzvr
jmpxhkoajn@ua.pt	ewvkyjapvs
neyacaqcme@ua.pt	daieugttth
jjmcjkixvs@ua.pt	jlzjnienmq
kwonjyawys@ua.pt	jpbhvxundl
ldhyxnvubs@ua.pt	crbwxocyui
qtuxvahofz@ua.pt	vrqdzjlsuw
tbbmbxanvm@ua.pt	ewhocazmbz
jtrztkinzt@ua.pt	onjskimkdr
fkjjvdbltw@ua.pt	owusursahe
xfzprfedju@ua.pt	feeaiyefnl
sxcqropido@ua.pt	genfrumtno
iqcrmssfaw@ua.pt	dcgpcfhzow
pmitgiqbcw@ua.pt	qgreqnxyui
bedtwzfwkp@ua.pt	uimrhhamxp
aggsgroebs@ua.pt	hlwntfagqb
mqtyoeuovh@ua.pt	pweovnwysu
lqdypwyiqr@ua.pt	tkfukudgov
ftsupgdpoa@ua.pt	odgkfgycvd
kpmqvuqcrs@ua.pt	fjdfzxxbdo
vfmaepnhil@ua.pt	bnhzzxkrgd
ksfhcvkbol@ua.pt	pbezovpetx
oijapsgske@ua.pt	hwesdctpse
igsqodhuln@ua.pt	hqldilgisc
hbgakvcwns@ua.pt	awvogsgrkz
